4
8
1111111111
1111111111
1111000211
1111011111
1000000111
1111011111
1111011111
1111011111
1111011111
1111111111