1
1
11111111111111111111111111111111111111111
10000000001010101010101000000010000000101
11111111101010101010101000011110000000101
10000000101000000000001010000010101010001
11111001101110011110011011100111101111111
10000000101000001000001010000000100010101
11111001101001111001101010011000100010101
10000000100000001000101010100010001010001
10011000100000001001101011100111111010011
10100010101010101000101010000010000000001
10111010101110111110111010011011100111111
10100010001000001000100010100010100000101
11100111111110001001100010111110100111101
10000000001000101000101010000010000010101
11111001111110111000101011100110000010101
10000000001000001010001010000010101000001
11111111111001111111111111111111111111111
10001000101000101000000010120000000010101
10011110101000101000011010111110011110101
10001000100010000010100000100010101010101
10011001111111111111100110111010101010101
10001000001010001000100010100010000000101
10011001101010001110100110100110011110101
10001010100000100000000010100010000010101
11101010111001111111111010100011111010101
10001000100000000000100010101000000010101
11101110111111100110111010111001111111101
10001000100000000010100010101010101000101
10001110111001111110111010101010101110101
10101000100000100010100010000000101000101
10111110100110111010111010011001101001101
10001000101000000010100010100000000000101
10011001101001100110100110100111111111101
10001000101000100010100010100000101000101
10011001101110100010111010111000101001101
10001000101000101010100010100010101010101
10011111111111111111111011111010101010101
10100000000000001000100000100010000000101
10100000011000001000100000100111100111101
10001010001010100010001010100010000000001
11111111111111111111111111111111111111111