0
7
111111100111100100111011001111111
100000100001000101001101101000001
101110100001101011010011101011101
101110100100110001010010101011101
101110100011010011010101001011101
100000101010011001101010101000001
111111101010101010101010101111111
000000000000000001011111000000000
100101101011111110011100110100000
001010001001100010001100111100011
111100101100000001011010110110101
011110010011101111001111110011001
100110101111100100000111111101010
101101001110000111000110111010011
000001101011010000101101011110110
111111001011001101010100001000010
010011100011111001010100101010010
101111011000010012100001000101010
011010100001110000100100000000111
111100000101010101110100101100001
000101110010101011100011010100011
110111000101000111111000111000111
001111100001111101101110001110001
101101000101100010000101100001000
011001100111111111111101111110010
000000001011100000011000100011001
111111100100100010001100101011100
100000101011001010011000100010000
101110100100111010010010111111001
101110101000001101011101101011010
101110100111100001000011110011101
100000100001001111100111101000000
111111101101010010001101110011010